XX..........
XXX..X..XXXX
..X...X.XXXX
X..X.....XXX
X..X..XX..XX
....X..X..XX
.XX.......XX
XXX..XX.. XX
..........XX
XX..XXXX..XX
..........XX
XXXXXX..XXXX
XX........XX
XXXXXXXXXXXX