X.XXX..X..X
X...X.X..XX
XX....XXXXX
X....X...XX
XXXX...XXXX
X........XX
XXXXXX...XX
.........XX
XXXXXXXXXXX